WWWWWWWWWWWWWWWWWWWWWWWWWWWWWWWWWWWWW
W1111111W211W111W111W111W112W1111111W
W1WWWWW1W1W1W1W1W1W1W1W1W1W1W1WWWWW1W
W1W111W1W1W111W111W111W111W1W1W111W1W
W1W1W1W1W1W1W1WWW1W1WWW1W1W1W1W1W1W1W
W1W11211W111W11111W11111W111W11211W1W
W1WWW1W1W1WWW1WWW1W1WWW1WWW1W1W1WWW1W
W11111111111W1WSSSSSSSW1W11111111111W
WWWWWWW1W1W1W1WSWWWWWSW1W1W1W1WWWWWWW
W11111W1W11111SSSSWSSSS11111W1W11111W
G1WWW1W1W1WWWWWSWSPSWSWWWWW1W1W1WWW1G
W1111111W11111WSWWSWWSW11111W1111111W
WWWWWWW1W1W1W1SSSSSSSSS1W1W1W1WWWWWWW
W11111111111W1WWWSWSWWW1W11111111111W
W1WWW1W1W1WWW1WSSSWSSSW1WWW1W1W1WWW1W
W1W11211W111W1W1WWWWW1W1W111W11211W1W
W1W1W1W1W1W1W1W1111111W1W1W1W1W1W1W1W
W1W111W1W1W111WWW1W1WWW111W1W1W111W1W
W1WWWWW1W1W1W1W111W111W1W1W1W1WWWWW1W
W1111111W211W111W111W111W112W1111111W
WWWWWWWWWWWWWWWWWWWWWWWWWWWWWWWWWWWWW