WWWWWWWWWWWWWWWWWWWWWWWWWWWWWWWWWWW
W11111111WWW11111W11111WWW11111111W
W1WW1W1W11111W1W1W1W1W11111W1W1WW1W
W1W21W1WWW1WWW1111111WWW1WWW1W12W1W
W111WW111111SWSWWWWWSWS111111WW111W
W1W11WWW1W1WSWSSSWSSSWSW1W1WWW11W1W
W1WW11111W1WSWWWSWSWWWSW1W11111WW1W
W1W11W1WWW1WSSSSSPSSSSSW1WWW1W11W1W
W111WW11111WWWWWSWSWWWWW11111WW111W
W1W1111WWW11SSSSSSSSSSS11WWW1111W1W
W1WW1W11111WSWSWWWWWSWSW11111W1WW1W
W1111W1WWW11SWSSSWSSSWS11WWW1W1111W
W1WWWW11111WWWWW1W1WWWWW11111WWWW1W
W111111WWW111111111111111WWW111111W
W1WW1W111W1WWW1W1W1W1WWW1W111W1WW1W
W1WW1W1W1W1W2W1W1W1W1W2W1W1W1W1WW1W
W1111111111111111W1111111111111111W
WWWWWWWWWWWWWWWWWWWWWWWWWWWWWWWWWWW
